1 1 1 1 1 1 1 1 1 1 1 1 1 1 1 1 1 1 1 1 1 1 1 1 1
1 0 0 0 0 0 0 0 0 0 0 0 0 0 0 0 0 0 0 0 7 3 4 0 1
1 0 1 0 6 0 0 1 0 0 0 0 0 0 0 0 0 0 0 0 0 3 0 0 1
1 0 1 1 1 0 1 1 1 1 1 1 1 1 1 0 0 0 0 0 0 3 3 3 1
1 0 1 0 0 0 0 1 0 0 0 2 2 2 1 0 0 10001 0 0 0 0 0 0 1
1 0 1 0 1 1 1 1 0 0 2 2 0 0 1 0 0 0 0 0 0 0 0 0 1
1 0 0 0 0 0 0 0 0 2 2 0 0 0 1 1 1 1 3 3 3 3 3 3 1
1 0 0 0 0 0 0 0 2 2 10100 0 0 0 1 0 0 0 0 0 1 3 3 3 1
1 0 0 0 0 0 0 0 2 2 0 0 0 0 1 0 0 0 0 0 1 0 0 0 1
1 0 0 0 0 0 6 6 0 0 0 0 0 0 0 0 0 0 0 0 1 0 0 0 1
1 0 0 0 0 6 6 6 0 0 0 0 0 0 0 0 0 0 0 0 1 0 0 0 1
1 0 0 0 0 6 6 0 0 0 0 0 0 0 0 0 0 0 0 0 1 0 0 0 1
1 3 3 3 1 1 1 1 1 1 1 1 1 1 0 0 0 0 0 0 1 0 0 0 1
1 3 3 3 3 3 0 0 0 5 5 5 5 5 5 5 5 5 5 5 5 5 5 5 1
1 0 3 3 3 3 0 0 0 5 5 5 5 5 5 5 5 5 5 5 5 5 5 5 1
1 0 0 0 0 0 0 6 6 0 0 0 0 1 1 1 1 1 1 1 0 0 0 6 1
1 0 0 0 0 0 6 6 6 0 0 0 3 3 3 0 0 0 0 0 0 0 6 6 1
1 0 0 0 0 0 6 6 0 0 0 0 3 3 3 0 0 0 0 0 0 6 6 6 1
1 0 0 0 0 0 0 0 0 0 0 0 3 3 3 0 0 0 0 0 6 6 6 6 1
1 1 1 1 1 1 1 1 1 1 1 1 1 1 1 1 1 1 1 1 1 1 1 1 1
