1 1 1 1 1 1 1 1 1 1 1 1 1 1 1 1 1 1 1 1 1 1 1 1 1
1 6 6 6 6 6 6 1 6 6 6 6 6 6 6 6 6 6 6 6 6 6 6 6 1
1 6 0 0 0 0 0 1 0 0 0 0 0 0 0 0 0 0 0 0 0 0 0 6 1
1 6 0 0 0 0 0 1 0 0 0 0 0 0 0 0 0 0 0 0 0 0 0 6 1
1 6 0 0 0 0 0 1 3 3 3 3 3 3 3 3 3 3 3 3 0 0 0 6 1
1 6 0 0 0 0 0 1 0 0 0 0 0 0 0 0 0 3 3 3 0 0 0 6 1
1 6 0 0 0 3 3 1 0 0 0 0 0 0 0 0 0 1 1 1 1 1 1 1 1
1 6 0 0 0 3 3 1 0 0 0 0 3 0 0 0 0 0 0 0 0 0 0 6 1
1 6 0 0 0 0 5 5 0 0 10002 3 2 3 10103 0 0 0 0 0 0 0 0 6 1
1 6 0 0 0 0 5 5 0 0 3 2 7 2 3 0 0 0 0 0 0 0 0 6 1
1 6 0 0 0 0 5 5 0 0 0 3 2 3 0 0 0 0 0 0 0 0 0 6 1
1 6 0 0 0 0 5 5 0 0 0 0 3 0 0 0 0 0 0 0 0 0 0 6 1
1 6 0 0 0 0 0 0 0 0 0 0 0 0 0 0 0 0 0 0 0 0 0 6 1
1 1 1 1 1 1 1 1 5 5 5 5 5 5 5 5 5 1 10200 0 0 0 0 6 1
1 6 0 0 0 10301 3 3 5 5 5 5 5 5 5 5 5 1 0 0 0 0 0 6 1
1 6 0 0 0 0 3 3 3 3 3 3 3 3 3 3 3 1 0 0 0 0 0 6 1
1 6 0 0 0 0 0 0 0 0 0 0 0 0 0 0 0 1 0 0 0 0 0 6 1
1 6 0 0 0 0 0 0 0 0 0 0 0 0 0 0 0 1 0 0 0 0 0 6 1
1 6 6 6 6 6 6 6 6 6 6 6 6 6 6 6 6 1 6 6 6 6 6 6 1
1 1 1 1 1 1 1 1 1 1 1 1 1 1 1 1 1 1 1 1 1 1 1 1 1